#####E#
##### #
#>    #
##### #
#######